p------------------p
p------------------p
p--pp--------------p
p------------------p
pp----p------------p
p------------------p
p-pppp----------p--p
p------------------p
p------------------p
p------------------p
p------------------p
p------------------p
p-p--------------p-p
ppp--------------ppp
p--------H---------p
p-------pppp-------p
p------------------p
p-----pp----pp-----p
p------------------p
pppppppp----pppppppp