--------------------
--------------------
--------------------
--------------------
--------------------
------pp----pp------
-s----------------s-
------pp----pp------
---------b----------
------pppppppp------
--------------------
p---p---------pp----
--s--------------s--
p---p---------pp----
---------H----------
--------pppp--------
--------------------
------pp----pp------
---s------------s---
p---pppp----pppp---p